향연	문학, 철학
데미안	문학, 철학
싯다르타	문학, 철학
지적 대화를 위한 넓고 얕은 지식0: 지혜를 찾아 138억년을 달리는 시간 여행서	총류
지적 대화를 위한 넓고 얕은 지식1: 역사, 경제, 정체, 사회, 윤리	총류
지적 대화를 위한 넓고 얕은 지식2: 철학, 과학, 예술, 종교, 신비	총류
나를 위한 최소한의 정치상식: 국회	사회과학
차라투스트라는 이렇게 말했다	문학, 철학
국가란 무엇인가	사회과학
과학혁명의 구조	자연과학, 철학
논리적 추론과 증명	수학, 철학
숲 생태학 강의	자연과학
기억의 뇌과학	사회과학
이기적 워드프로세서 : 실기 기본서	총류
17살, 돈의 가치를 알아야할 나이	사회과학
5일만에 끝내는 서양미술사	예술
5일만에 끝내는 클래식 음악사	예술
1984	문학
노인과 바다	문학
위대한 유산	문학
오만과 편견	문학
여행의 이유	문학
멋진 신세계	문학
불편한 편의점	문학
마당이 있는 집	문학
교과서에 실려있는 한국대표시	문학
한국단편소설 모음	문학
돼지가 한 마리도 죽지 않던 날	문학
git 교과서	컴퓨터공학
빛의 양자컴퓨터	컴퓨터공학
리얼월드 알고리즘	컴퓨터공학
밑바닥부터 시작하는 딥러닝1	컴퓨터공학
혼자 공부하는 얄팍한 코딩 지식	컴퓨터공학
혼자 공부하는 컴퓨터 구조, 운영체제	컴퓨터공학
컴퓨터과학이 여는 세계	컴퓨터공학
성공과 실패를 결정하는 1%의 네트워크 원리	컴퓨터공학
자바스크립트+jQuery 완전정복 스터디. 1: 기초편	컴퓨터공학
생활코딩! PHP+MySQL	컴퓨터공학
